0 0 0 0 0 0 0 0 0 0 0 0 
0 4 5 5 4 0 0 5 0 1 0 0 
0 4 3 2 3 0 0 2 9 5 0 0 
0 4 2 0 0 5 5 5 0 3 0 0  
0 0 0 9 0 2 0 0 0 4 5 0 
0 0 0 0 1 0 0 0 0 5 4 0 
0 4 5 4 0 2 1 0 1 1 1 0 
0 0 9 0 1 0 2 0 3 3 2 0 
0 0 0 2 0 2 0 2 0 1 1 0 
0 0 0 5 9 0 0 0 0 4 0 0  
0 0 0 0 0 0 5 5 4 4 0 0  
0 0 0 0 0 0 0 0 0 0 0 0 

3 1 3