0 0 0 0 0 0 0 0 0 0 0 0 
0 2 0 0 4 0 5 0 3 0 0 0 
0 5 0 0 3 0 3 0 3 0 0 0 
0 5 2 5 0 5 3 0 0 3 3 0  
0 5 0 0 5 3 0 3 2 0 0 0 
0 2 0 0 5 5 0 5 2 0 0 0 
0 5 5 5 5 5 0 0 0 0 0 0 
0 5 0 5 0 1 1 0 0 3 4 0 
0 3 0 3 0 1 0 1 3 0 0 0 
0 0 3 2 0 0 5 2 0 3 0 0  
0 0 2 0 2 0 5 0 0 0 0 0  
0 0 0 0 0 0 0 0 0 0 0 0 

6 2 2