0 0 0 0 0 0 0 0 0 0 0 0 
0 2 0 0 4 0 5 0 3 0 0 0 
0 5 0 0 3 0 3 0 3 0 0 0 
0 0 2 5 0 5 3 0 0 3 3 0  
0 5 0 0 5 3 0 3 2 0 0 0 
0 2 0 0 5 5 0 5 2 0 0 0 
0 0 0 0 0 0 0 0 0 0 0 0 
0 5 0 5 0 1 5 2 3 0 4 0 
0 3 3 3 0 1 5 1 0 3 0 0 
0 2 0 2 5 4 0 2 0 0 0 0  
0 0 2 0 4 5 0 0 0 0 0 0  
0 0 0 0 0 0 0 0 0 0 0 0 

3 3 2